R 1000 600
NO ./tex/wood.xpm
SO ./tex/metal.xpm
WE ./tex/Stone.xpm
EA ./tex/skull_octocat.xpm
S ./tex/skull_octocat.xpm

F 173,173,173
C 125,175,255

111111111111111111111111
111111111111111111111111
100000000000000000000001 
100000000000000000000001 
100020000000000000000001
100020000000000000000001
100000000000000000000001
100000000000000000000001
110000000110000111110001
110000000110000111110001
100000000000000000010001
100000000000000000010001
100000000010000100010001
100000000010000100010001
100000000010000110010001
100000000010000110010001
100000111110000100000001
100000111110000100000001
100000000000000000000001
100000000000000000000001
100000000000000000000001
100000000000000000000001
100000000000000000000001 
100000000000000000000001 
111000000000000200000001
100000000000000000000001
101110000000000000000001111111111111
1000010000000000000000000000000000001
1000000000000000000000011111111111101
100000000000000000000001          101 
100000000000000000000001          101 
10000000000000000000000111111111111011111111111
100000000000000000000000002000000000000000000001
100000000000000000000000000002000000000000000001
100000000000000000000000200200002000200000000001
10000000000000N0000000000000200020000200000000001
1000000000000000000000000000200000000000200220000111
100000000000000000000000020020002000000202202020000011
1000000000000000000000020020002200020002220200200000001
100000000000000000000000000002020202000020002000000001
100000000000000000000000002000022020002200200000000001
10000000000000000000000000002000200200200200200000001
1000000000000000000000000002020200202220002000000001
100000000000000000000000020000020000002002002000011
10000000000000000000000000200000200200000000000001
10000000000000000000020000020000000000000000000001
10000000000000000000000020200000000000000000000001
1000000000000000000000000000000000000000000000011
100000000000000000000000000000000000000000000001
100000000000000000000000222222222222220000000001
100000000000000000000000222222222222220000000001
100000000000000000000000222222222222220000000001
100000000000000000000000222222222222220000000001
100000000000000000000000222222222222220000000001
100000000000000000000000222222222222220000000001
100000000000000000000000222222222222220000000001
100000000000000000000000222222222222220000000001
100000000000000000000000222222222222220000000001
100000000000000000000000222222222222220000000001
100000000000000000000000222222222222220000000001
100000000000000000000000222222222222220000000001
100000000000000000000000222222222222220000000001
100000000000000000000000222222222222220000000001
100000000000000000000000222222222222220000000001
100000000000000000000000000000000000000000000001
100000000000000000000000000000000000000000000001
100000000000000000000000000000000000000000000001
100000000000000000000000000000000000000000000001
100000000000000000000000000000000000000000000001
100000000000000000000000000000000000000000000001
100000000000000000000000000000000000000000000001
100000000000000000000000000000000000000000000001
100000000000000000000000000000000000000000000001
100000000000000000000000000000000000000000000001
100000000000000000000000000000000000000000000001
100000000000000000000000000000000000000000000001
100000000000000000000000000000000000000000000001
100000000000000000000000000000000000000000000001
100000000000000000000000000000000000000000000001
100000000000000000000000000000000000000000000001
100000000000000000000000000000000000000000000001
100000000000000000000000000000000000000000000001
100000000000000000000000000000000000000000000001
100000000000000000000000000000000000000000000001
100000000000000000000001111111111111111111111111
100000000000000000000001
100000000000000000000001
100000000000000000000001
100000000000000000000001
100000000000000000000001
100000000000000000000001
100000000000000000000001
100000000000000000000001
100000000000000000000001
100000000000000000000001
100000000000000000000001
100000000000000000000001
100000000000000000000001
100000000000000000000001
100000000000000000000001
100000000000000000000001
100000000000000000000001
100000000000000000000001
100000000000000000000001
100001000100010000011101
100000000000000000000001
100000000000000000000001
100000000000000000000001
100000000000000000000001
100000000000000000000001
100000000001000000100001
100000000000000000000001
100000000000000000000001
100000000000000000000001
101001010000001000000101
101001010000001000000101
101001010000001000000101
101001010000001000000101
101001010000001000000101
101001010000001000000101
101001010000001000000101
101001010000001000000101
101001010000001000000101
101001010000001000000101
101001010000001000000101
101001010000001000000101
101001010000001000000101
101001010000001000000101
101001010000001000000101
101001010000001000000101
101001010000001000000101
101001010000001000000101
101001010000001000000101
101001010000001000000101
101001010000001000000101
101001010000001000000101
101001010000001000000101
101001010000001000000101
101001010000001000000101
101001010000001000000101
101001010000001000000101
101001010000001000000101
101001010000001000000101
101001010000001000000101
101001010000001000000101
101001010000001000000101
101001010000001000000101
101001010000001000000101
101001010000001000000101
101001010000001000000101
101001010000001000000101
101001010000001000000101
101001010000001000000101
101001010000001000000101
101001010000001000000101
101001010000001000000101
101001010000001000000101
100000000000000000000001
111111111111111111111111
