R 1000 600
NO ./tex/wood.xpm
SO ./tex/metal.xpm
WE ./tex/Stone.xpm
EA ./tex/skull_octocat.xpm
S ./tex/alex.xpm

F 173,173,173
C 125,175,255

111111111111111111111111
111111111111111111111111
100000000000000000000001 
100000000000000000000001 
100020000000000000000001
100020000000000000000001
100000000000000000000001
100000000000000000000001
110000000110000111110001
110000000110000111110001
100000000000000000010001
100000000000000000010001
100000000010000100010001
100000000010000100010001
100000000010000110010001
100000000010000110010001
100000111110000100000001
100000111110000100000001
100000000000000000000001
100000000000000000000001
100000000000000000000001
100000000000000000000001
100000000000000000000001 
100000000000000000000001 
111000000000000200000001
100000000000000000000001
101110000000000000000001
100001000000000000000001
100000000000000000000001
100000000000000000000001
100000000000000000000001
10000000000000000000000111111111111111111111111
100000000000000000000000000000000000000000000001
100000000000000000000000000000000000000000000001
100000000000000000000000000000000000000000000001
10000000000000N000000000000000000000000000000001
100000000000000000000000000000000000000000000001
100000000000000000000000000000000000000000000001
100000000000000000000002000000000000000000000001
100000000000000000000000000000000000000000000001
100000000000000000000000000000000000000000000001
100000000000000000000000000000000000000000000001
100000000000000000000000000000000000000000000001
100000000000000000000000000000000000000000000001
100000000000000000000000000000000000000000000001
100000000000000000000000000000000000000000000001
100000000000000000000001111111111111111111111111
100000000000000000000001
100000000000000000000001
100000000000000000000001
100000000000000000000001
100000000000000000000001
100000000000000000000001
100000000000000000000001
100000000000000000000001
100000000000000000000001
100000000000000000000001
100000000000000000000001
100000000000000000000001
100000000000000000000001
100000000000000000000001
100000000000000000000001
100000000000000000000001
100000000000000000000001
100000000000000000000001
100000000000000000000001
100001000100010000011101
100000000000000000000001
100000000000000000000001
100000000000000000000001
100000000000000000000001
100000000000000000000001
100000000001000000100001
100000000000000000000001
100000000000000000000001
100000000000000000000001
101001010000001000000101
101001010000001000000101
101001010000001000000101
101001010000001000000101
101001010000001000000101
101001010000001000000101
101001010000001000000101
101001010000001000000101
101001010000001000000101
101001010000001000000101
101001010000001000000101
101001010000001000000101
101001010000001000000101
101001010000001000000101
101001010000001000000101
101001010000001000000101
101001010000001000000101
101001010000001000000101
101001010000001000000101
101001010000001000000101
101001010000001000000101
101001010000001000000101
101001010000001000000101
101001010000001000000101
101001010000001000000101
101001010000001000000101
101001010000001000000101
101001010000001000000101
101001010000001000000101
101001010000001000000101
101001010000001000000101
101001010000001000000101
101001010000001000000101
101001010000001000000101
101001010000001000000101
101001010000001000000101
101001010000001000000101
101001010000001000000101
101001010000001000000101
101001010000001000000101
101001010000001000000101
101001010000001000000101
101001010000001000000101
100000000000000000000001
111111111111111111111111
