R 100 100
NO ./tex/metal.xpm
SO ./tex/wood.xpm
WE ./tex/stone.xpm
EA ./tex/wood.xpm
S ./tex/skull_octocat.xpm
F 209,209,209
C 23,236,255

11111111111111111111111111111
10000000001100000000000000001
10110000011120020020W00010001
10010000000002000000000010001
10110000011100000000000010001
10000000001100000111011110001
11110111111111011100000010001
11110111111111011101010010001
11000000110101011100000010001
10002000000000001100000010201
10000000000000001101010010001
11000000110101011111011110001
11110101111101011111011110001
11111100111111111111111110001
10000010000000000000000010001
10111011111111111111111010001
10001000000000000000000010001
11101111111111111111111110001
10000000000000000000000100001
10000000100000000000000101101
10000000000000000000000100001
10000010201000000001110010001
10000000000000000010001001001
10000000100000000010111100101
10000000000000000000000100001
11111111111111111111111111111
