R 1000 800
NO 75,155,105
SO ./tex/skull_octocat.xpm
WE ./tex/skull_octocat.xpm
EA ./tex/skull_octocat.xpm
S ./tex/skull_octocat.xpm

F 252,0,255
C 225,30,0

111111111111111111111111
100000100000000000000001
100000100000000000000001
100000100000000000000001
111101000110000111110001
100000000000000000010001
100000000010000100010001
100000000010000110010001
100000111110000100000001
100000000000000000000001
100000000000000000000001
100000000000000000000001
111000000000000000000001
100000000000000000000001
101110000000000N00000001
100001000000000000000001
111101111000000000000001
110100001100000000000001
110000101010000000000001
110100001001000000000011
110111111000100000000101
110000000000010000001001
111111111000001000010001
111111111111111111111111
