R 1000 800
NO 75,155,105
SO ./tex/skull_octocat.xpm
WE ./tex/skull_octocat.xpm
EA ./tex/skull_octocat.xpm
S ./tex/skull_octocat.xpm

F 252,0,255
C 225,30,0

111111
110101
1N0001
110011
111111
