R 1000  600
WE ./tex/wood.xpm
NO ./tex/stone.xpm
SO ./tex/metal.xpm
EA ./tex/alex.xpm
S ./tex/pillar.xpm
F 209,209,209
C 23,236,255


  111 111 111 11111111                   
 1000100010001000000001
 1010101010101010000001
 1010101010101010020001
 1010101010101010000001
 1010101010101010002001
 1010101010101010000001
 1010101010101010200001
 1010101010101010002001
 1N10001000100010000001
10011111111 111 110111
10100000000000000001
10001111111111111111
 1111