R 1000 800

NO ./tex/8-bit.png
SO 252,3,207
WE 252,3,207
EA 252,3,207
S 252,3,207

C 225,30,0

111111
100001
1N2001
100001
100201
100021
111111
