R 1000  800
NO ./tex/stone.xpm
WE ./tex/wood.xpm
SO ./tex/metal.xpm
EA ./tex/skull_octocat.xpm
S ./tex/pillar.xpm
F 252,3,207
C 225,30,0

111111
100001
101001
100001
100001
100001
100001
100001
100001
100011
100N01
111111
