R 1000 800
NO 75,155,105
SO ./tex/skull_octocat.xpm
WE ./tex/skull_octocat.xpm
EA ./tex/skull_octocat.xpm
S ./tex/skull_octocat.xpm
F 252,3,207
C 225,30,0

111111
100001
1N2001
100001
100201
100021
111111
